00 00 00 02 12 12 12 12 12 12 12 12 12 12 12 12 12 12 12 12 12 12 12
00 00 00 12 12 12 12 12 12 12 12 12 12 12 12 12 12 12 12 12 12 12 12
00 00 00 12 02 03 12 03 03 12 12 12 12 12 12 12 12 12 12 12 12 12 12
00 00 00 12 02 03 12 03 03 12 12 05 12 12 03 03 03 03 03 03 03 12 12
00 00 00 12 02 03 12 03 03 12 12 05 12 12 03 02 02 02 02 02 03 12 12
00 00 00 12 02 12 12 12 03 12 12 05 12 12 03 02 02 02 02 02 03 12 12
00 00 00 12 12 12 12 12 12 12 12 05 12 12 03 03 03 03 03 03 03 12 12
00 00 00 12 12 12 06 12 12 12 12 05 12 12 12 12 12 12 12 12 12 12 12
00 00 00 12 13 12 12 12 12 12 12 05 12 12 12 12 12 12 12 12 12 12 12
00 00 00 12 12 12 12 12 12 12 12 12 12 12 00 00 00 12 12 12 12 12 12
00 00 00 12 04 12 12 12 12 12 12 12 06 12 00 00 00 12 12 12 12 12 12
00 00 00 12 12 12 12 12 12 12 12 12 12 12 00 00 00 12 12 12 12 12 12
00 00 00 12 12 12 12 12 12 12 02 02 12 12 12 02 12 12 12 12 12 12 12
00 00 00 12 12 12 04 12 12 12 12 12 12 12 12 12 12 12 12 12 12 12 12
00 00 00 12 12 12 12 12 12 12 12 12 12 12 12 12 12 12 12 12 12 12 12
00 00 00 12 12 12 12 12 12 03 03 12 12 12 12 12 12 12 12 12 12 12 12
00 00 00 12 12 12 12 12 03 03 03 12 12 12 12 12 12 12 12 12 12 12 12
00 00 00 12 12 12 12 03 03 03 03 12 12 12 12 12 09 12 12 12 12 12 12
00 00 00 12 12 12 12 03 03 03 12 12 12 12 12 12 07 08 12 12 12 12 12
00 00 00 12 13 12 12 12 12 12 12 12 12 12 12 12 12 12 12 12 12 12 12
00 00 00 12 12 12 12 12 12 12 12 12 06 12 12 12 12 12 12 12 12 12 12
00 00 00 12 12 02 02 12 12 12 12 12 12 12 12 12 12 12 12 12 12 12 12
00 00 00 12 02 02 02 02 12 12 12 12 12 12 12 12 12 12 12 12 12 12 12
00 00 00 12 12 02 02 12 12 12 12 12 12 12 12 12 12 12 12 12 12 12 12
00 00 00 12 12 12 12 12 12 12 06 12 12 12 12 12 12 12 03 12 12 12 12
00 00 00 12 12 12 12 12 12 12 12 12 12 04 12 12 12 12 12 12 12 12 12
00 00 00 12 03 03 03 12 12 12 12 12 12 12 12 12 12 13 12 12 12 12 12
00 00 00 12 03 03 03 12 12 12 12 12 12 12 12 12 12 12 12 12 12 12 12
00 00 00 12 12 12 12 12 04 12 12 12 12 12 12 12 12 12 12 12 12 12 12
00 00 00 12 12 12 12 12 12 12 12 12 12 12 12 12 12 12 06 12 12 12 12
00 00 00 12 12 12 12 12 12 12 12 12 12 12 12 12 12 12 12 12 12 12 12
00 00 00 12 12 12 12 12 12 12 12 12 12 12 12 06 12 12 12 12 12 12 12
00 00 00 12 12 12 12 12 12 12 12 12 12 12 12 12 12 12 12 12 04 12 12
00 00 00 12 12 12 12 12 12 12 04 12 12 12 12 12 12 13 12 12 12 12 12
00 00 00 12 12 13 12 12 12 12 12 12 12 12 12 12 12 12 12 12 12 12 12
